6  6  6  6  6  0  0  0  0  6  6  6  6  6  6
6  6  6  6  5  0  1  1  2  5  0  0  5  6  6
6  6  1  1  1  1  4  5  2  0  0  0  1  1  1
6  6  4  5  0  0  0  0  2  5  0  0  4  5  0
6  5  4  0  0  0  0  5  2  0  0  5  4  0  6
0  0  4  3  5  0  6  6  2  0  0  0  4  0  6
0  0  5  4  0  6  6  0  2  5  0  0  4  6  6
1  1  1  4  0  6  0  5  1  1  2  5  4  6  6
6  5  6  6  6  0  0  0  0  5  1  1  4  5  6
6  6  6  6  6  6  6  0  0  0  6  6  6  6  6